1111111111111111111111
1E0000000000000C000001
1010010100100000101001
100000000C00C000000001
1P1001010010000010100
1111111111111111111111
