11111111111
1C100000001
1C100000001
100000C0001
1E000100001
1P000000001
11111111111