11111111111
1C100000001
1C100000001
100000C0001
1E000100001
1P100000001
10100000001
10111011111
10000000001
10000000001
10000000001
10000000001
10000000001
11111111111