11111111111111
10000000P00001
100001000C1101
100000000000E1
100000C0000001
11111111111111