1111111111111111111111
1P000C0000000C00000001
1000000000000000000E01
1000000000000000000001
1000000000000000000001
1000000000000000000001
1111111111111111111111
