1111111111111111111111
1E0000000000000C000001
1010010100100000101001
100000000C00C000000001
1P10010100100000101001
1111111111111111111111
