1111111111111111111111
1P00000000000C00000E01
1111111111111111111111
