11111111111111
10000000000001
1000010P0C1111
10000000000001
100000C000E011
1000000000o001
11111111111111
