1111111111111111111111111111111111111111
1111111111111111111111111111111111111111
1P0000000C00C00000000000000C00C0000000E1
1111111111111111111111111111111111111111
1111111111111111111111111111111111111111
