111111111111111111111111111111111111111111111111
111111111111111111111111111111111111111111111111
1P0000000C00C0000000000E000C00C0000000000000C001
111111111111111111111111111111111111111111111111
111111111111111111111111111111111111111111111111
