1111111111111111111111111111
10010000000G010000001000G001
1P0000010C00C0001000000000E1
1010010000010000G0000100G001
1111111111111111111111111111
