1111111111111111111111111111
10010000000G0100001G10001001
1P0000010C00C0001000G00000E1
1010010000010000000000000101
1111111111111111111111111111
