1111111111111111111111111111111111111111
1000000000000000000000000000000000000001
1P0000000C00C00000000000000C00C0000000E1
1000000000000000G00000000000000000000001
1111111111111111111111111111111111111111
